AIF	BINARY
AIFF	BINARY
AIFC	BINARY
AS	ASCII
ASCX	ASCII
ASMX	ASCII
ASP	ASCII
ASPX	ASCII
BIN	BINARY
BMP	BINARY
CFM	ASCII
CFML	ASCII
CGI	ASCII
CS	ASCII
CSS	ASCII
DCR	BINARY
DIR	BINARY
DOC	BINARY
DWT	ASCII
DXR	BINARY
EXE	BINARY
FLA	BINARY
GIF	BINARY
HTM	ASCII
HTML	ASCII
INC	ASCII
JPG	BINARY
JPEG	BINARY
JS	ASCII 
LBI	ASCII
MNO	BINARY
MOV	BINARY
MPEG	BINARY
MPG	BINARY
MXML	ASCII
PDF	BINARY
PHP	ASCII
PHP3	ASCII
PHP4	ASCII
PHP5	ASCII
PIC	BINARY
PICT	BINARY
PNG	BINARY
QT	BINARY
RA	BINARY
RAM	BINARY
README	BINARY
RM	BINARY
RTF	BINARY
SEA	BINARY
SHTM	ASCII
SHTML	ASCII
SIT	BINARY
SND	BINARY
SWF	BINARY
TEXT	ASCII
TIF	BINARY
TIFF	BINARY
TPL	BINARY
TXT	ASCII
VB	ASCII
WAV	BINARY
XHTM	ASCII
XHTML	ASCII
ZIP	BINARY
